//MAP CONVERTED BY dmm2tgm.py THIS HEADER COMMENT PREVENTS RECONVERSION, DO NOT REMOVE
"a" = (
/turf/open/space/basic,
/area/space)
"e" = (
/obj/machinery/light/directional/east,
/turf/open/floor/iron,
/area/centcom/central_command_areas)
"f" = (
/turf/closed/constructed_wall/bronze,
/area/centcom/central_command_areas)
"h" = (
/obj/machinery/light/directional/south,
/turf/open/floor/iron,
/area/centcom/central_command_areas)
"k" = (
/turf/closed/constructed_wall/wood_oak,
/area/centcom/central_command_areas)
"n" = (
/turf/closed/constructed_wall/wood_cherry,
/area/centcom/central_command_areas)
"o" = (
/turf/closed/constructed_wall/silver,
/area/centcom/central_command_areas)
"r" = (
/turf/closed/constructed_wall/plasteel,
/area/centcom/central_command_areas)
"s" = (
/turf/open/floor/iron,
/area/centcom/central_command_areas)
"v" = (
/turf/open/floor/light,
/area/centcom/central_command_areas)
"w" = (
/obj/machinery/light/directional/west,
/turf/open/floor/light,
/area/centcom/central_command_areas)
"x" = (
/obj/machinery/light/directional/north,
/turf/open/floor/iron,
/area/centcom/central_command_areas)
"y" = (
/turf/closed/constructed_wall/shielded,
/area/centcom/central_command_areas)
"A" = (
/obj/docking_port/mobile/emergency{
	width = 3;
	dwidth = 1;
	dheight = 3;
	height = 0;
	dir = 8
	},
/obj/machinery/door/airlock/shuttle{
	dir = 4
	},
/turf/open/floor/iron,
/area/shuttle)
"B" = (
/turf/closed/constructed_wall/wood_dark_oak,
/area/centcom/central_command_areas)
"F" = (
/turf/closed/constructed_wall/marble_black,
/area/centcom/central_command_areas)
"G" = (
/obj/effect/landmark/observer_start,
/turf/open/floor/iron,
/area/centcom/central_command_areas)
"H" = (
/turf/closed/constructed_wall/stellar,
/area/centcom/central_command_areas)
"I" = (
/turf/open/floor/light,
/area/shuttle)
"K" = (
/turf/closed/constructed_wall/steel,
/area/centcom/central_command_areas)
"L" = (
/turf/closed/constructed_wall/wood_teak,
/area/centcom/central_command_areas)
"M" = (
/obj/machinery/announcement_system,
/turf/open/floor/iron,
/area/centcom/central_command_areas)
"R" = (
/obj/effect/landmark/error,
/turf/open/floor/iron,
/area/centcom/central_command_areas)
"S" = (
/turf/closed/constructed_wall/wood_mahogany,
/area/centcom/central_command_areas)
"T" = (
/obj/machinery/light/directional/west,
/turf/open/floor/iron,
/area/centcom/central_command_areas)
"V" = (
/obj/effect/landmark/start,
/turf/open/floor/iron,
/area/centcom/central_command_areas)
"X" = (
/turf/closed/constructed_wall/marble_white,
/area/centcom/central_command_areas)
"Y" = (
/turf/closed/constructed_wall/stellar,
/area/shuttle)
"Z" = (
/turf/closed/constructed_wall/steel/steel,
/area/centcom/central_command_areas)

(1,1,1) = {"
a
a
a
a
a
a
a
a
a
a
a
a
a
a
a
a
a
a
k
k
S
S
n
n
a
a
X
X
F
F
f
f
"}
(2,1,1) = {"
a
a
a
a
a
a
a
a
a
a
a
a
a
a
a
a
a
a
k
s
T
T
h
n
H
H
X
s
T
T
s
f
"}
(3,1,1) = {"
a
a
a
a
a
a
a
a
a
a
a
a
a
a
a
a
a
a
L
x
V
s
s
v
w
w
v
s
s
s
h
r
"}
(4,1,1) = {"
a
a
a
a
a
a
a
a
a
a
a
a
a
a
a
a
a
a
L
x
G
s
s
v
v
v
v
s
s
s
h
r
"}
(5,1,1) = {"
a
a
a
a
a
a
a
a
a
a
a
a
a
a
a
a
a
a
k
s
e
e
h
B
v
v
K
s
e
e
s
y
"}
(6,1,1) = {"
a
a
a
a
a
a
a
a
a
a
a
a
a
a
a
a
a
a
k
k
S
S
B
B
s
s
K
K
o
o
y
y
"}
(7,1,1) = {"
a
a
a
a
a
a
a
a
a
a
a
a
a
a
a
Y
A
Y
a
Y
A
Y
Z
s
s
s
R
Z
a
a
a
a
"}
(8,1,1) = {"
a
a
a
a
a
a
a
a
a
a
a
a
a
a
a
Y
I
Y
a
Y
I
Y
Z
M
e
e
s
Z
a
a
a
a
"}
(9,1,1) = {"
a
a
a
a
a
a
a
a
a
a
a
a
a
a
a
Y
Y
Y
a
Y
Y
Y
Z
Z
Z
Z
Z
Z
a
a
a
a
"}
(10,1,1) = {"
a
a
a
a
a
a
a
a
a
a
a
a
a
a
a
a
a
a
a
a
a
a
a
a
a
a
a
a
a
a
a
a
"}
(11,1,1) = {"
a
a
a
a
a
a
a
a
a
a
a
a
a
a
a
a
a
a
a
a
a
a
a
a
a
a
a
a
a
a
a
a
"}
(12,1,1) = {"
a
a
a
a
a
a
a
a
a
a
a
a
a
a
a
a
a
a
a
a
a
a
a
a
a
a
a
a
a
a
a
a
"}
(13,1,1) = {"
a
a
a
a
a
a
a
a
a
a
a
a
a
a
a
a
a
a
a
a
a
a
a
a
a
a
a
a
a
a
a
a
"}
(14,1,1) = {"
a
a
a
a
a
a
a
a
a
a
a
a
a
a
a
a
a
a
a
a
a
a
a
a
a
a
a
a
a
a
a
a
"}
(15,1,1) = {"
a
a
a
a
a
a
a
a
a
a
a
a
a
a
a
a
a
a
a
a
a
a
a
a
a
a
a
a
a
a
a
a
"}
(16,1,1) = {"
a
a
a
a
a
a
a
a
a
a
a
a
a
a
a
a
a
a
a
a
a
a
a
a
a
a
a
a
a
a
a
a
"}
(17,1,1) = {"
a
a
a
a
a
a
a
a
a
a
a
a
a
a
a
a
a
a
a
a
a
a
a
a
a
a
a
a
a
a
a
a
"}
(18,1,1) = {"
a
a
a
a
a
a
a
a
a
a
a
a
a
a
a
a
a
a
a
a
a
a
a
a
a
a
a
a
a
a
a
a
"}
(19,1,1) = {"
a
a
a
a
a
a
a
a
a
a
a
a
a
a
a
a
a
a
a
a
a
a
a
a
a
a
a
a
a
a
a
a
"}
(20,1,1) = {"
a
a
a
a
a
a
a
a
a
a
a
a
a
a
a
a
a
a
a
a
a
a
a
a
a
a
a
a
a
a
a
a
"}
(21,1,1) = {"
a
a
a
a
a
a
a
a
a
a
a
a
a
a
a
a
a
a
a
a
a
a
a
a
a
a
a
a
a
a
a
a
"}
(22,1,1) = {"
a
a
a
a
a
a
a
a
a
a
a
a
a
a
a
a
a
a
a
a
a
a
a
a
a
a
a
a
a
a
a
a
"}
(23,1,1) = {"
a
a
a
a
a
a
a
a
a
a
a
a
a
a
a
a
a
a
a
a
a
a
a
a
a
a
a
a
a
a
a
a
"}
(24,1,1) = {"
a
a
a
a
a
a
a
a
a
a
a
a
a
a
a
a
a
a
a
a
a
a
a
a
a
a
a
a
a
a
a
a
"}
(25,1,1) = {"
a
a
a
a
a
a
a
a
a
a
a
a
a
a
a
a
a
a
a
a
a
a
a
a
a
a
a
a
a
a
a
a
"}
(26,1,1) = {"
a
a
a
a
a
a
a
a
a
a
a
a
a
a
a
a
a
a
a
a
a
a
a
a
a
a
a
a
a
a
a
a
"}
(27,1,1) = {"
a
a
a
a
a
a
a
a
a
a
a
a
a
a
a
a
a
a
a
a
a
a
a
a
a
a
a
a
a
a
a
a
"}
(28,1,1) = {"
a
a
a
a
a
a
a
a
a
a
a
a
a
a
a
a
a
a
a
a
a
a
a
a
a
a
a
a
a
a
a
a
"}
(29,1,1) = {"
a
a
a
a
a
a
a
a
a
a
a
a
a
a
a
a
a
a
a
a
a
a
a
a
a
a
a
a
a
a
a
a
"}
(30,1,1) = {"
a
a
a
a
a
a
a
a
a
a
a
a
a
a
a
a
a
a
a
a
a
a
a
a
a
a
a
a
a
a
a
a
"}
(31,1,1) = {"
a
a
a
a
a
a
a
a
a
a
a
a
a
a
a
a
a
a
a
a
a
a
a
a
a
a
a
a
a
a
a
a
"}
(32,1,1) = {"
a
a
a
a
a
a
a
a
a
a
a
a
a
a
a
a
a
a
a
a
a
a
a
a
a
a
a
a
a
a
a
a
"}
